11111111111111111111111
10010000000C0000CC00001
10000111110010100011111
1P0011E0000011111000011
111111111101111C1101111
10010000000C10000C00101
10000111110011101111101
1000110000001C000000011
11111111111111111111111