111111111111111111111111111111
100000000000000010000000000001
101111111111101111111111111101
10000P0000C00100000000C0000001
101111000011101111000011111101
1C0000000C0000000C00000000C001
101111000111111001111100011101
1010000C00001000000000C0000001
101111100001111000011110001111
1010000000C00000000000C0000001
101111000011111000011111000E01
100000C0000000C00000C000000001
101111111111111111111111111101
100000000000000000000000000001
111111101111111111101111111111
100000001000000000100000000001
101111101111101111101111101101
1X0100000000C0000000C0000000C1
101111111111101111111111111101
10000000C0C0101000000000000001
111111111111111111111111111111