11111111111111
10000000000001
10110111111101
10000P00000001
10111011111101
1C00000000C001
11111100001E01
1X000000000C01
11111111111111
1000C0C0000001
11111111111111